4 4 4 4 4 4 4 4 4 4
4 4 4 4 4 4 4 4 4 4
4 4 4 4 4 4 4 4 4 4
4 1 1 1 1 1 1 1 1 4
4 1 3 0 0 0 0 0 1 4
4 1 0 3 2 2 2 9 1 4
4 1 3 0 0 0 0 0 1 4
4 1 1 1 1 1 0 0 1 4
4 4 4 4 4 1 1 1 1 4
4 4 4 4 4 4 4 4 4 4
